"source","target","total_reviews.x","rating_sum.x","mean_rating.x","total_reviews.y","rating_sum.y","mean_rating.y","n","mean_rating"
"AG3jFaQcABSFF-ry3l5t5g","glmwOs55H49Q_D8ENZtqYQ",3,7,2.33333333333333,4,12,3,7,2.71428571428571
"AG3jFaQcABSFF-ry3l5t5g","MnoF8A3UAghzXKSunNSn2Q",3,7,2.33333333333333,2,4,2,5,2.2
"AdEFp9zXwOO84mc1OC37aA","moX-9x1Z76IlcAM3bAu4bg",10,47,4.7,4,14,3.5,14,4.35714285714286
"AdEFp9zXwOO84mc1OC37aA","cny9rhnhcYsJuTq2q4wp2A",10,47,4.7,6,20,3.33333333333333,16,4.1875
"AdEFp9zXwOO84mc1OC37aA","-5RN56jH78MV2oquLV_G8g",10,47,4.7,4,18,4.5,14,4.64285714285714
"QhwkFogGQA-Ar176Ul5PUQ","s5-VDvUqyYnD8RG3LPqnbQ",49,195,3.97959183673469,26,95,3.65384615384615,75,3.86666666666667
"QhwkFogGQA-Ar176Ul5PUQ","Iyy4pDmnKTZkAorzclO4Eg",49,195,3.97959183673469,6,29,4.83333333333333,55,4.07272727272727
"QhwkFogGQA-Ar176Ul5PUQ","sIyHTizqAiGu12XMLX3N3g",49,195,3.97959183673469,42,153,3.64285714285714,91,3.82417582417582
"QhwkFogGQA-Ar176Ul5PUQ","eq6lQI039SBLC6sHm3idGA",49,195,3.97959183673469,18,81,4.5,67,4.11940298507463
"QhwkFogGQA-Ar176Ul5PUQ","zt1TpTuJ6y9n551sw9TaEg",49,195,3.97959183673469,22,67,3.04545454545455,71,3.69014084507042
"QhwkFogGQA-Ar176Ul5PUQ","Ieuv-XET6SR_qIscZzgD-A",49,195,3.97959183673469,3,13,4.33333333333333,52,4
"QhwkFogGQA-Ar176Ul5PUQ","n8aEflHJYlK_c7yy8xkwpQ",49,195,3.97959183673469,3,13,4.33333333333333,52,4
"QhwkFogGQA-Ar176Ul5PUQ","2e2e7WgqU1BnpxmQL5jbfw",49,195,3.97959183673469,21,83,3.95238095238095,70,3.97142857142857
"QhwkFogGQA-Ar176Ul5PUQ","05tazaFQt1EnQ_Gk_1AFyg",49,195,3.97959183673469,5,22,4.4,54,4.01851851851852
"QhwkFogGQA-Ar176Ul5PUQ","a1t31qMLd5fQocEjbSJ61A",49,195,3.97959183673469,2,3,1.5,51,3.88235294117647
"QhwkFogGQA-Ar176Ul5PUQ","tcphcsPONrP82kUyvcELoA",49,195,3.97959183673469,6,21,3.5,55,3.92727272727273
"QhwkFogGQA-Ar176Ul5PUQ","szw8OGJlsqaA3i2oe7dn9A",49,195,3.97959183673469,5,16,3.2,54,3.90740740740741
"QhwkFogGQA-Ar176Ul5PUQ","-5RN56jH78MV2oquLV_G8g",49,195,3.97959183673469,4,18,4.5,53,4.0188679245283
"QhwkFogGQA-Ar176Ul5PUQ","CZjcFdvJhksq9dy58NVEzw",49,195,3.97959183673469,6,19,3.16666666666667,55,3.89090909090909
"QhwkFogGQA-Ar176Ul5PUQ","6qXQQOWdUZiJmWVqkWB-3w",49,195,3.97959183673469,5,14,2.8,54,3.87037037037037
"QhwkFogGQA-Ar176Ul5PUQ","DO3Gk17RyJVW7zYMCtYPnw",49,195,3.97959183673469,10,37,3.7,59,3.93220338983051
"QhwkFogGQA-Ar176Ul5PUQ","xyTJYlbE_MLouK6rCou6zg",49,195,3.97959183673469,6,20,3.33333333333333,55,3.90909090909091
"FvDa81O48IZx_LhjSiv_bQ","cny9rhnhcYsJuTq2q4wp2A",4,18,4.5,6,20,3.33333333333333,10,3.8
"FvDa81O48IZx_LhjSiv_bQ","bdsKG7MQIMmZ73lgOaTZ0A",4,18,4.5,5,7,1.4,9,2.77777777777778
"FvDa81O48IZx_LhjSiv_bQ","uYKwS-biARKgBkk5rY_PaQ",4,18,4.5,5,24,4.8,9,4.66666666666667
"2E3OHy9UBnj3hoVw9RKx-Q","kAXwEMkpcKMObw45QJGqnw",3,13,4.33333333333333,4,17,4.25,7,4.28571428571429
"FudNA-KYx-QKaeyghJoPAg","BqrTtox0JbG-P_DKBB5bBw",4,8,2,18,69,3.83333333333333,22,3.5
"FqhEd4vV6Hg-0J49hBShUQ","3fV9sL5LklD9ZSeONKmjkw",4,15,3.75,8,21,2.625,12,3
"FqhEd4vV6Hg-0J49hBShUQ","J4qLz0nGzCTMf6-kf_SiQg",4,15,3.75,4,10,2.5,8,3.125
"vlKGOytpJnYGW-bnILhg6Q","bmNPNlCLDplWB55ic3Bixg",4,17,4.25,6,24,4,10,4.1
"XqpUYK7tjHe_gi0BrNf1sw","uYKwS-biARKgBkk5rY_PaQ",6,25,4.16666666666667,5,24,4.8,11,4.45454545454545
"XqpUYK7tjHe_gi0BrNf1sw","BqD7X5CHXnJ14YbBBlLx1w",6,25,4.16666666666667,7,32,4.57142857142857,13,4.38461538461539
"XqpUYK7tjHe_gi0BrNf1sw","vaq5SJubaZjIoGhgkwxxUA",6,25,4.16666666666667,1,5,5,7,4.28571428571429
"XqpUYK7tjHe_gi0BrNf1sw","xhh72bIFefOaAxsj4vJJaA",6,25,4.16666666666667,1,4,4,7,4.14285714285714
"WnBSlcek6ACsjE0UDJ1l2A","aGbjLWzcrnEx2ZmMCFm3EA",8,34,4.25,36,141,3.91666666666667,44,3.97727272727273
"WnBSlcek6ACsjE0UDJ1l2A","eq6lQI039SBLC6sHm3idGA",8,34,4.25,18,81,4.5,26,4.42307692307692
"WnBSlcek6ACsjE0UDJ1l2A","DO3Gk17RyJVW7zYMCtYPnw",8,34,4.25,10,37,3.7,18,3.94444444444444
"gfdRSaGFthB2HiIVSA1raA","k8bSp5BfCNCKqTXcKALXtw",3,10,3.33333333333333,6,27,4.5,9,4.11111111111111
"WzDvQdS7MQrWK7vyDjdR4Q","GjQbbMwu8OzictyBdgYY5g",7,24,3.42857142857143,10,32,3.2,17,3.29411764705882
"WzDvQdS7MQrWK7vyDjdR4Q","Xhg93cMdemu5pAMkDoEdtQ",7,24,3.42857142857143,16,54,3.375,23,3.39130434782609
"GjQbbMwu8OzictyBdgYY5g","KcWUgvyl64Vp0PfwQRZQkw",10,32,3.2,12,38,3.16666666666667,22,3.18181818181818
"GjQbbMwu8OzictyBdgYY5g","cN6qpVw6RaSrSI-JGGF4Tw",10,32,3.2,3,11,3.66666666666667,13,3.30769230769231
"GjQbbMwu8OzictyBdgYY5g","BqrTtox0JbG-P_DKBB5bBw",10,32,3.2,18,69,3.83333333333333,28,3.60714285714286
"GjQbbMwu8OzictyBdgYY5g","QRXv7Jvq_SuiiT_SKvbdig",10,32,3.2,5,21,4.2,15,3.53333333333333
"GjQbbMwu8OzictyBdgYY5g","DO3Gk17RyJVW7zYMCtYPnw",10,32,3.2,10,37,3.7,20,3.45
"mcWm0MqN4rRKE_3uwhtmkA","6D24UL_dB6CKLvqwkA4-Yg",3,7,2.33333333333333,1,5,5,4,3
"moX-9x1Z76IlcAM3bAu4bg","aGbjLWzcrnEx2ZmMCFm3EA",4,14,3.5,36,141,3.91666666666667,40,3.875
"moX-9x1Z76IlcAM3bAu4bg","8zL3V6rmFKBess3bxPLAoQ",4,14,3.5,4,13,3.25,8,3.375
"moX-9x1Z76IlcAM3bAu4bg","jOuERtVf7QePnK9ZcdH5XA",4,14,3.5,10,35,3.5,14,3.5
"cny9rhnhcYsJuTq2q4wp2A","bdsKG7MQIMmZ73lgOaTZ0A",6,20,3.33333333333333,5,7,1.4,11,2.45454545454545
"cny9rhnhcYsJuTq2q4wp2A","uYKwS-biARKgBkk5rY_PaQ",6,20,3.33333333333333,5,24,4.8,11,4
"bdsKG7MQIMmZ73lgOaTZ0A","uYKwS-biARKgBkk5rY_PaQ",5,7,1.4,5,24,4.8,10,3.1
"s5-VDvUqyYnD8RG3LPqnbQ","ateowLnq6kpgNNWHzCDByQ",26,95,3.65384615384615,18,68,3.77777777777778,44,3.70454545454545
"s5-VDvUqyYnD8RG3LPqnbQ","Hww3i4P9WsVLsTyXrCG89w",26,95,3.65384615384615,3,11,3.66666666666667,29,3.6551724137931
"s5-VDvUqyYnD8RG3LPqnbQ","2QtowmXBL6-4KMpfavljbw",26,95,3.65384615384615,3,12,4,29,3.68965517241379
"s5-VDvUqyYnD8RG3LPqnbQ","sIyHTizqAiGu12XMLX3N3g",26,95,3.65384615384615,42,153,3.64285714285714,68,3.64705882352941
"s5-VDvUqyYnD8RG3LPqnbQ","Ieuv-XET6SR_qIscZzgD-A",26,95,3.65384615384615,3,13,4.33333333333333,29,3.72413793103448
"s5-VDvUqyYnD8RG3LPqnbQ","naLrErBuJr9IWd6_rv6-XQ",26,95,3.65384615384615,6,28,4.66666666666667,32,3.84375
"s5-VDvUqyYnD8RG3LPqnbQ","2e2e7WgqU1BnpxmQL5jbfw",26,95,3.65384615384615,21,83,3.95238095238095,47,3.78723404255319
"s5-VDvUqyYnD8RG3LPqnbQ","k8bSp5BfCNCKqTXcKALXtw",26,95,3.65384615384615,6,27,4.5,32,3.8125
"s5-VDvUqyYnD8RG3LPqnbQ","8zL3V6rmFKBess3bxPLAoQ",26,95,3.65384615384615,4,13,3.25,30,3.6
"s5-VDvUqyYnD8RG3LPqnbQ","tFU2Js_nbIZOrnKfYJYBBg",26,95,3.65384615384615,8,34,4.25,34,3.79411764705882
"s5-VDvUqyYnD8RG3LPqnbQ","DO3Gk17RyJVW7zYMCtYPnw",26,95,3.65384615384615,10,37,3.7,36,3.66666666666667
"s5-VDvUqyYnD8RG3LPqnbQ","xyTJYlbE_MLouK6rCou6zg",26,95,3.65384615384615,6,20,3.33333333333333,32,3.59375
"s5-VDvUqyYnD8RG3LPqnbQ","ASOiJ8MmbBTgK2D1_MQrqg",26,95,3.65384615384615,5,13,2.6,31,3.48387096774194
"KcWUgvyl64Vp0PfwQRZQkw","ateowLnq6kpgNNWHzCDByQ",12,38,3.16666666666667,18,68,3.77777777777778,30,3.53333333333333
"KcWUgvyl64Vp0PfwQRZQkw","w29d_3Ua0_JlOaAk89Sr2w",12,38,3.16666666666667,5,20,4,17,3.41176470588235
"KcWUgvyl64Vp0PfwQRZQkw","LH6aLuXW3yShrn_pzrVe8g",12,38,3.16666666666667,3,7,2.33333333333333,15,3
"KcWUgvyl64Vp0PfwQRZQkw","BqrTtox0JbG-P_DKBB5bBw",12,38,3.16666666666667,18,69,3.83333333333333,30,3.56666666666667
"KcWUgvyl64Vp0PfwQRZQkw","js12Ev8XKlh36gZeGHzQnA",12,38,3.16666666666667,2,5,2.5,14,3.07142857142857
"KcWUgvyl64Vp0PfwQRZQkw","3fV9sL5LklD9ZSeONKmjkw",12,38,3.16666666666667,8,21,2.625,20,2.95
"KcWUgvyl64Vp0PfwQRZQkw","UpMR63WZgIn8VDKnYpDwXA",12,38,3.16666666666667,5,11,2.2,17,2.88235294117647
"KcWUgvyl64Vp0PfwQRZQkw","vW4G1hwiW6LkuhAfbeRfqg",12,38,3.16666666666667,4,13,3.25,16,3.1875
"KcWUgvyl64Vp0PfwQRZQkw","tcphcsPONrP82kUyvcELoA",12,38,3.16666666666667,6,21,3.5,18,3.27777777777778
"KcWUgvyl64Vp0PfwQRZQkw","9CLZ-Uwv3nmOlbbGCIhvrQ",12,38,3.16666666666667,3,9,3,15,3.13333333333333
"KcWUgvyl64Vp0PfwQRZQkw","tFU2Js_nbIZOrnKfYJYBBg",12,38,3.16666666666667,8,34,4.25,20,3.6
"KcWUgvyl64Vp0PfwQRZQkw","4bEjOyTaDG24SY5TxsaUNQ",12,38,3.16666666666667,27,113,4.18518518518519,39,3.87179487179487
"KcWUgvyl64Vp0PfwQRZQkw","DO3Gk17RyJVW7zYMCtYPnw",12,38,3.16666666666667,10,37,3.7,22,3.40909090909091
"KcWUgvyl64Vp0PfwQRZQkw","TwxHMCcRdF_CQb_EZ6kPQQ",12,38,3.16666666666667,3,10,3.33333333333333,15,3.2
"ateowLnq6kpgNNWHzCDByQ","Hww3i4P9WsVLsTyXrCG89w",18,68,3.77777777777778,3,11,3.66666666666667,21,3.76190476190476
"ateowLnq6kpgNNWHzCDByQ","sIyHTizqAiGu12XMLX3N3g",18,68,3.77777777777778,42,153,3.64285714285714,60,3.68333333333333
"ateowLnq6kpgNNWHzCDByQ","zt1TpTuJ6y9n551sw9TaEg",18,68,3.77777777777778,22,67,3.04545454545455,40,3.375
"ateowLnq6kpgNNWHzCDByQ","3fV9sL5LklD9ZSeONKmjkw",18,68,3.77777777777778,8,21,2.625,26,3.42307692307692
"ateowLnq6kpgNNWHzCDByQ","8zL3V6rmFKBess3bxPLAoQ",18,68,3.77777777777778,4,13,3.25,22,3.68181818181818
"ateowLnq6kpgNNWHzCDByQ","UpMR63WZgIn8VDKnYpDwXA",18,68,3.77777777777778,5,11,2.2,23,3.43478260869565
"ateowLnq6kpgNNWHzCDByQ","vW4G1hwiW6LkuhAfbeRfqg",18,68,3.77777777777778,4,13,3.25,22,3.68181818181818
"ateowLnq6kpgNNWHzCDByQ","tcphcsPONrP82kUyvcELoA",18,68,3.77777777777778,6,21,3.5,24,3.70833333333333
"0xSf8B4DBEk8ecV7YYXVUw","BQjGE1Z3nk253XzIZqt8Gg",3,13,4.33333333333333,2,7,3.5,5,4
"0xSf8B4DBEk8ecV7YYXVUw","zt1TpTuJ6y9n551sw9TaEg",3,13,4.33333333333333,22,67,3.04545454545455,25,3.2
"0xSf8B4DBEk8ecV7YYXVUw","bRYNYkMSghVlszXcOtA2XA",3,13,4.33333333333333,1,2,2,4,3.75
"PbfrZVqGWDVWklKKxmVkzw","QbmcCE_cLq4WO8ZMKImaLw",4,17,4.25,22,87,3.95454545454545,26,4
"PbfrZVqGWDVWklKKxmVkzw","WqdCrAhYSewDAom1qY-t_g",4,17,4.25,3,8,2.66666666666667,7,3.57142857142857
"PbfrZVqGWDVWklKKxmVkzw","aSZzH68--YxNQYAO5nKBkA",4,17,4.25,4,16,4,8,4.125
"PbfrZVqGWDVWklKKxmVkzw","2a4OsAIvlWifELjogNPT1Q",4,17,4.25,1,3,3,5,4
"PbfrZVqGWDVWklKKxmVkzw","R4_DQvJzYmWfFn1l-JPZMg",4,17,4.25,1,3,3,5,4
"PbfrZVqGWDVWklKKxmVkzw","voPFKvVFm7b01xUyJixFYA",4,17,4.25,2,10,5,6,4.5
"UjAj7SjUQg8znkwk_gaDJw","sIyHTizqAiGu12XMLX3N3g",11,39,3.54545454545455,42,153,3.64285714285714,53,3.62264150943396
"UjAj7SjUQg8znkwk_gaDJw","nZgYNbl1XlZyyKlISMoG6w",11,39,3.54545454545455,11,33,3,22,3.27272727272727
"UjAj7SjUQg8znkwk_gaDJw","eq6lQI039SBLC6sHm3idGA",11,39,3.54545454545455,18,81,4.5,29,4.13793103448276
"UjAj7SjUQg8znkwk_gaDJw","SwmStS3zjj94aV8M7kYqLg",11,39,3.54545454545455,7,30,4.28571428571429,18,3.83333333333333
"UjAj7SjUQg8znkwk_gaDJw","zTCCbg7mGslxACL5KlAPIQ",11,39,3.54545454545455,6,14,2.33333333333333,17,3.11764705882353
"UjAj7SjUQg8znkwk_gaDJw","M2SjLXsuAy5RNKwxaA5E1g",11,39,3.54545454545455,4,15,3.75,15,3.6
"UjAj7SjUQg8znkwk_gaDJw","mU57qypB4nLScxgowHNEUA",11,39,3.54545454545455,3,6,2,14,3.21428571428571
"UjAj7SjUQg8znkwk_gaDJw","DO3Gk17RyJVW7zYMCtYPnw",11,39,3.54545454545455,10,37,3.7,21,3.61904761904762
"UjAj7SjUQg8znkwk_gaDJw","Q_Rwcv9APBLggk2KAsBEvg",11,39,3.54545454545455,5,17,3.4,16,3.5
"lfmvmL6iHq9-IDABLeNsuw","cMvN1j-LK64zqmT4vnl8NA",5,23,4.6,7,17,2.42857142857143,12,3.33333333333333
"lfmvmL6iHq9-IDABLeNsuw","zt1TpTuJ6y9n551sw9TaEg",5,23,4.6,22,67,3.04545454545455,27,3.33333333333333
"lfmvmL6iHq9-IDABLeNsuw","zTCCbg7mGslxACL5KlAPIQ",5,23,4.6,6,14,2.33333333333333,11,3.36363636363636
"lfmvmL6iHq9-IDABLeNsuw","4EhFsjWBSaSp_5TkkLp7LA",5,23,4.6,3,8,2.66666666666667,8,3.875
"lfmvmL6iHq9-IDABLeNsuw","ASOiJ8MmbBTgK2D1_MQrqg",5,23,4.6,5,13,2.6,10,3.6
"w29d_3Ua0_JlOaAk89Sr2w","LH6aLuXW3yShrn_pzrVe8g",5,20,4,3,7,2.33333333333333,8,3.375
"w29d_3Ua0_JlOaAk89Sr2w","BqrTtox0JbG-P_DKBB5bBw",5,20,4,18,69,3.83333333333333,23,3.8695652173913
"w29d_3Ua0_JlOaAk89Sr2w","9CLZ-Uwv3nmOlbbGCIhvrQ",5,20,4,3,9,3,8,3.625
"w29d_3Ua0_JlOaAk89Sr2w","4bEjOyTaDG24SY5TxsaUNQ",5,20,4,27,113,4.18518518518519,32,4.15625
"Hww3i4P9WsVLsTyXrCG89w","sIyHTizqAiGu12XMLX3N3g",3,11,3.66666666666667,42,153,3.64285714285714,45,3.64444444444444
"Hww3i4P9WsVLsTyXrCG89w","8zL3V6rmFKBess3bxPLAoQ",3,11,3.66666666666667,4,13,3.25,7,3.42857142857143
"y8VQQO_WkYNjSLcq6hyjPA","uyEUL3Oskfa1fOYCksyM8A",5,18,3.6,4,12,3,9,3.33333333333333
"y8VQQO_WkYNjSLcq6hyjPA","QozXMHqNzkVutP-FhcP30w",5,18,3.6,5,12,2.4,10,3
"y8VQQO_WkYNjSLcq6hyjPA","aYEs_eXqnV8Ifj3Bp0bHwQ",5,18,3.6,3,12,4,8,3.75
"y8VQQO_WkYNjSLcq6hyjPA","N50HceZf1595UtU867u4uQ",5,18,3.6,4,15,3.75,9,3.66666666666667
"y8VQQO_WkYNjSLcq6hyjPA","M2SjLXsuAy5RNKwxaA5E1g",5,18,3.6,4,15,3.75,9,3.66666666666667
"y8VQQO_WkYNjSLcq6hyjPA","9CLZ-Uwv3nmOlbbGCIhvrQ",5,18,3.6,3,9,3,8,3.375
"y8VQQO_WkYNjSLcq6hyjPA","aSZzH68--YxNQYAO5nKBkA",5,18,3.6,4,16,4,9,3.77777777777778
"8TbIx8H3FufrHlYZH4IcWg","hINoWktWMam3fJmETzzCDw",1,3,3,1,5,5,2,4
"1Zj3JOukVxyU2kq4Vhju9A","Ieuv-XET6SR_qIscZzgD-A",4,16,4,3,13,4.33333333333333,7,4.14285714285714
"1Zj3JOukVxyU2kq4Vhju9A","aYEs_eXqnV8Ifj3Bp0bHwQ",4,16,4,3,12,4,7,4
"RQYsXLFFefpCNkWkJ3gCnA","cQMfAN2YVUcJn8wK2M_wGw",3,12,4,3,14,4.66666666666667,6,4.33333333333333
"RQYsXLFFefpCNkWkJ3gCnA","PNThcRNEFI3azvfhvhd_KA",3,12,4,3,9,3,6,3.5
"RQYsXLFFefpCNkWkJ3gCnA","jOuERtVf7QePnK9ZcdH5XA",3,12,4,10,35,3.5,13,3.61538461538462
"eiYDLEWkGY6df3sb1z6evw","BqD7X5CHXnJ14YbBBlLx1w",2,9,4.5,7,32,4.57142857142857,9,4.55555555555556
"eiYDLEWkGY6df3sb1z6evw","rP76z9iDOFczywAiee-l7A",2,9,4.5,1,4,4,3,4.33333333333333
"eiYDLEWkGY6df3sb1z6evw","t65wgP7lQrCqxjBpMwOdbw",2,9,4.5,1,3,3,3,4
"2f8o3-FRnq3rwmstUCOZ7A","aGbjLWzcrnEx2ZmMCFm3EA",2,4,2,36,141,3.91666666666667,38,3.81578947368421
"2f8o3-FRnq3rwmstUCOZ7A","9Bnc9YP0n5cR57xkP6fQmQ",2,4,2,5,19,3.8,7,3.28571428571429
"2f8o3-FRnq3rwmstUCOZ7A","83C1eqPfmQHTy_8MC4Ug6w",2,4,2,1,3,3,3,2.33333333333333
"Iyy4pDmnKTZkAorzclO4Eg","alWTl5MRC4VE2t9W1mNSIQ",6,29,4.83333333333333,5,17,3.4,11,4.18181818181818
"Iyy4pDmnKTZkAorzclO4Eg","8_HGHlHsNdCnTsLQYHteAw",6,29,4.83333333333333,2,8,4,8,4.625
"cP6pQuoPKIoaFQBa09e-Vg","KcSJUq1kwO8awZRMS6Q49g",2,6,3,2,6,3,4,3
"U8pLRrR-17w74U5cWLDWmA","iXA8Y2bzvZo8MjALfZxrIg",2,9,4.5,3,13,4.33333333333333,5,4.4
"uyEUL3Oskfa1fOYCksyM8A","ObSi1ZpICXPSO95ZTQByNQ",4,12,3,1,4,4,5,3.2
"uyEUL3Oskfa1fOYCksyM8A","aYEs_eXqnV8Ifj3Bp0bHwQ",4,12,3,3,12,4,7,3.42857142857143
"uyEUL3Oskfa1fOYCksyM8A","N50HceZf1595UtU867u4uQ",4,12,3,4,15,3.75,8,3.375
"uyEUL3Oskfa1fOYCksyM8A","M2SjLXsuAy5RNKwxaA5E1g",4,12,3,4,15,3.75,8,3.375
"uyEUL3Oskfa1fOYCksyM8A","9CLZ-Uwv3nmOlbbGCIhvrQ",4,12,3,3,9,3,7,3
"uyEUL3Oskfa1fOYCksyM8A","aSZzH68--YxNQYAO5nKBkA",4,12,3,4,16,4,8,3.5
"CoHBmblS6DNCx4yH69jiug","QRXv7Jvq_SuiiT_SKvbdig",2,7,3.5,5,21,4.2,7,4
"CoHBmblS6DNCx4yH69jiug","SsTxjxo8qvqBMvan1rzNzg",2,7,3.5,10,38,3.8,12,3.75
"72ngj2ky908bsW9Ae40R0A","DO3Gk17RyJVW7zYMCtYPnw",2,6,3,10,37,3.7,12,3.58333333333333
"aGbjLWzcrnEx2ZmMCFm3EA","OL6SSsa9D7Z4IQIPJ_EGJA",36,141,3.91666666666667,3,12,4,39,3.92307692307692
"aGbjLWzcrnEx2ZmMCFm3EA","sIyHTizqAiGu12XMLX3N3g",36,141,3.91666666666667,42,153,3.64285714285714,78,3.76923076923077
"aGbjLWzcrnEx2ZmMCFm3EA","mDdqifuTrfXAOfxiLMGu5Q",36,141,3.91666666666667,17,64,3.76470588235294,53,3.86792452830189
"aGbjLWzcrnEx2ZmMCFm3EA","eq6lQI039SBLC6sHm3idGA",36,141,3.91666666666667,18,81,4.5,54,4.11111111111111
"aGbjLWzcrnEx2ZmMCFm3EA","zt1TpTuJ6y9n551sw9TaEg",36,141,3.91666666666667,22,67,3.04545454545455,58,3.58620689655172
"aGbjLWzcrnEx2ZmMCFm3EA","dxY1gl4cO4-rEFATCkFUIw",36,141,3.91666666666667,8,25,3.125,44,3.77272727272727
"aGbjLWzcrnEx2ZmMCFm3EA","NYg-hgqjQvq5RDRcV7iv8A",36,141,3.91666666666667,1,3,3,37,3.89189189189189
"aGbjLWzcrnEx2ZmMCFm3EA","QcTj9AgGJA0ifMHCCPNblg",36,141,3.91666666666667,1,2,2,37,3.86486486486486
"aGbjLWzcrnEx2ZmMCFm3EA","LTMEAdWM4m5tIDCSrkALIg",36,141,3.91666666666667,2,10,5,38,3.97368421052632
"aGbjLWzcrnEx2ZmMCFm3EA","x42C5j84k0Y4H20fcJwbRQ",36,141,3.91666666666667,1,5,5,37,3.94594594594595
"aGbjLWzcrnEx2ZmMCFm3EA","8zL3V6rmFKBess3bxPLAoQ",36,141,3.91666666666667,4,13,3.25,40,3.85
"aGbjLWzcrnEx2ZmMCFm3EA","9Bnc9YP0n5cR57xkP6fQmQ",36,141,3.91666666666667,5,19,3.8,41,3.90243902439024
"aGbjLWzcrnEx2ZmMCFm3EA","rBPQuQgTcMtUq5-RYhY2uQ",36,141,3.91666666666667,8,15,1.875,44,3.54545454545455
"aGbjLWzcrnEx2ZmMCFm3EA","SLyacGZuMUKqrQJEooSkjw",36,141,3.91666666666667,7,22,3.14285714285714,43,3.7906976744186
"aGbjLWzcrnEx2ZmMCFm3EA","83C1eqPfmQHTy_8MC4Ug6w",36,141,3.91666666666667,1,3,3,37,3.89189189189189
"OL6SSsa9D7Z4IQIPJ_EGJA","eq6lQI039SBLC6sHm3idGA",3,12,4,18,81,4.5,21,4.42857142857143
"OL6SSsa9D7Z4IQIPJ_EGJA","rBPQuQgTcMtUq5-RYhY2uQ",3,12,4,8,15,1.875,11,2.45454545454545
"OL6SSsa9D7Z4IQIPJ_EGJA","SLyacGZuMUKqrQJEooSkjw",3,12,4,7,22,3.14285714285714,10,3.4
"OL6SSsa9D7Z4IQIPJ_EGJA","YacTpiq0ZptFcXD7I-kdGA",3,12,4,4,19,4.75,7,4.42857142857143
"2QtowmXBL6-4KMpfavljbw","tFU2Js_nbIZOrnKfYJYBBg",3,12,4,8,34,4.25,11,4.18181818181818
"hsM6PF4Of6RMNcQV_c-FVQ","sIyHTizqAiGu12XMLX3N3g",5,19,3.8,42,153,3.64285714285714,47,3.65957446808511
"hsM6PF4Of6RMNcQV_c-FVQ","eq6lQI039SBLC6sHm3idGA",5,19,3.8,18,81,4.5,23,4.34782608695652
"hsM6PF4Of6RMNcQV_c-FVQ","SwmStS3zjj94aV8M7kYqLg",5,19,3.8,7,30,4.28571428571429,12,4.08333333333333
"sIyHTizqAiGu12XMLX3N3g","RE3xkxkjmHQIARrLSIeerg",42,153,3.64285714285714,5,16,3.2,47,3.59574468085106
"sIyHTizqAiGu12XMLX3N3g","eq6lQI039SBLC6sHm3idGA",42,153,3.64285714285714,18,81,4.5,60,3.9
"sIyHTizqAiGu12XMLX3N3g","BqrTtox0JbG-P_DKBB5bBw",42,153,3.64285714285714,18,69,3.83333333333333,60,3.7
"sIyHTizqAiGu12XMLX3N3g","QbmcCE_cLq4WO8ZMKImaLw",42,153,3.64285714285714,22,87,3.95454545454545,64,3.75
"sIyHTizqAiGu12XMLX3N3g","Xhg93cMdemu5pAMkDoEdtQ",42,153,3.64285714285714,16,54,3.375,58,3.56896551724138
"sIyHTizqAiGu12XMLX3N3g","3fV9sL5LklD9ZSeONKmjkw",42,153,3.64285714285714,8,21,2.625,50,3.48
"sIyHTizqAiGu12XMLX3N3g","_xmJB767rROtAy6XepMlkQ",42,153,3.64285714285714,4,11,2.75,46,3.56521739130435
"sIyHTizqAiGu12XMLX3N3g","2e2e7WgqU1BnpxmQL5jbfw",42,153,3.64285714285714,21,83,3.95238095238095,63,3.74603174603175
"sIyHTizqAiGu12XMLX3N3g","a1t31qMLd5fQocEjbSJ61A",42,153,3.64285714285714,2,3,1.5,44,3.54545454545455
"sIyHTizqAiGu12XMLX3N3g","8zL3V6rmFKBess3bxPLAoQ",42,153,3.64285714285714,4,13,3.25,46,3.60869565217391
"sIyHTizqAiGu12XMLX3N3g","J4qLz0nGzCTMf6-kf_SiQg",42,153,3.64285714285714,4,10,2.5,46,3.54347826086957
"sIyHTizqAiGu12XMLX3N3g","szw8OGJlsqaA3i2oe7dn9A",42,153,3.64285714285714,5,16,3.2,47,3.59574468085106
"sIyHTizqAiGu12XMLX3N3g","-5RN56jH78MV2oquLV_G8g",42,153,3.64285714285714,4,18,4.5,46,3.71739130434783
"sIyHTizqAiGu12XMLX3N3g","SLyacGZuMUKqrQJEooSkjw",42,153,3.64285714285714,7,22,3.14285714285714,49,3.57142857142857
"sIyHTizqAiGu12XMLX3N3g","CZjcFdvJhksq9dy58NVEzw",42,153,3.64285714285714,6,19,3.16666666666667,48,3.58333333333333
"sIyHTizqAiGu12XMLX3N3g","mU57qypB4nLScxgowHNEUA",42,153,3.64285714285714,3,6,2,45,3.53333333333333
"sIyHTizqAiGu12XMLX3N3g","tFU2Js_nbIZOrnKfYJYBBg",42,153,3.64285714285714,8,34,4.25,50,3.74
"sIyHTizqAiGu12XMLX3N3g","4bEjOyTaDG24SY5TxsaUNQ",42,153,3.64285714285714,27,113,4.18518518518519,69,3.85507246376812
"sIyHTizqAiGu12XMLX3N3g","ASOiJ8MmbBTgK2D1_MQrqg",42,153,3.64285714285714,5,13,2.6,47,3.53191489361702
"wxtqWVGlDW4JFDOAKofIog","vbZ0BWZK1fbBjetxe3sTOQ",4,11,2.75,1,3,3,5,2.8
"cQMfAN2YVUcJn8wK2M_wGw","PNThcRNEFI3azvfhvhd_KA",3,14,4.66666666666667,3,9,3,6,3.83333333333333
"cQMfAN2YVUcJn8wK2M_wGw","YacTpiq0ZptFcXD7I-kdGA",3,14,4.66666666666667,4,19,4.75,7,4.71428571428571
"BQjGE1Z3nk253XzIZqt8Gg","zt1TpTuJ6y9n551sw9TaEg",2,7,3.5,22,67,3.04545454545455,24,3.08333333333333
"BQjGE1Z3nk253XzIZqt8Gg","bRYNYkMSghVlszXcOtA2XA",2,7,3.5,1,2,2,3,3
"EF5vR_UUavzPjtgMYFCg5Q","QbmcCE_cLq4WO8ZMKImaLw",4,4,1,22,87,3.95454545454545,26,3.5
"VdY6qe9afspFwsbzX1HsOQ","7_fiK6AQbcBlAXsoS7QZRw",2,6,3,1,4,4,3,3.33333333333333
"mDdqifuTrfXAOfxiLMGu5Q","3fV9sL5LklD9ZSeONKmjkw",17,64,3.76470588235294,8,21,2.625,25,3.4
"glmwOs55H49Q_D8ENZtqYQ","MnoF8A3UAghzXKSunNSn2Q",4,12,3,2,4,2,6,2.66666666666667
"LH6aLuXW3yShrn_pzrVe8g","BqrTtox0JbG-P_DKBB5bBw",3,7,2.33333333333333,18,69,3.83333333333333,21,3.61904761904762
"LH6aLuXW3yShrn_pzrVe8g","9CLZ-Uwv3nmOlbbGCIhvrQ",3,7,2.33333333333333,3,9,3,6,2.66666666666667
"LH6aLuXW3yShrn_pzrVe8g","4bEjOyTaDG24SY5TxsaUNQ",3,7,2.33333333333333,27,113,4.18518518518519,30,4
"IRYj1b1-mlXqABVsl9SoqQ","_tS0YfyPDxOXxrN4Kl2_HQ",5,23,4.6,2,9,4.5,7,4.57142857142857
"IRYj1b1-mlXqABVsl9SoqQ","6qXQQOWdUZiJmWVqkWB-3w",5,23,4.6,5,14,2.8,10,3.7
"nZgYNbl1XlZyyKlISMoG6w","XziiAJUc8cgj3McljtnYVw",11,33,3,2,6,3,13,3
"XziiAJUc8cgj3McljtnYVw","4bEjOyTaDG24SY5TxsaUNQ",2,6,3,27,113,4.18518518518519,29,4.10344827586207
"9SrR4mkEsyimsimrc-vP4w","2e2e7WgqU1BnpxmQL5jbfw",4,14,3.5,21,83,3.95238095238095,25,3.88
"9SrR4mkEsyimsimrc-vP4w","TN49j3bUJr3fuKCJkCatSA",4,14,3.5,1,2,2,5,3.2
"RE3xkxkjmHQIARrLSIeerg","BqrTtox0JbG-P_DKBB5bBw",5,16,3.2,18,69,3.83333333333333,23,3.69565217391304
"RE3xkxkjmHQIARrLSIeerg","Xhg93cMdemu5pAMkDoEdtQ",5,16,3.2,16,54,3.375,21,3.33333333333333
"RE3xkxkjmHQIARrLSIeerg","ZZcKMWza1-GqrmhzFHW_mw",5,16,3.2,1,5,5,6,3.5
"eq6lQI039SBLC6sHm3idGA","cMvN1j-LK64zqmT4vnl8NA",18,81,4.5,7,17,2.42857142857143,25,3.92
"eq6lQI039SBLC6sHm3idGA","cN6qpVw6RaSrSI-JGGF4Tw",18,81,4.5,3,11,3.66666666666667,21,4.38095238095238
"eq6lQI039SBLC6sHm3idGA","zt1TpTuJ6y9n551sw9TaEg",18,81,4.5,22,67,3.04545454545455,40,3.7
"eq6lQI039SBLC6sHm3idGA","BqrTtox0JbG-P_DKBB5bBw",18,81,4.5,18,69,3.83333333333333,36,4.16666666666667
"eq6lQI039SBLC6sHm3idGA","SwmStS3zjj94aV8M7kYqLg",18,81,4.5,7,30,4.28571428571429,25,4.44
"eq6lQI039SBLC6sHm3idGA","_45p8kOA__aNycVVe-n-KA",18,81,4.5,1,4,4,19,4.47368421052632
"eq6lQI039SBLC6sHm3idGA","NxsCqQCpofRx08m535JYIA",18,81,4.5,1,4,4,19,4.47368421052632
"eq6lQI039SBLC6sHm3idGA","9Bnc9YP0n5cR57xkP6fQmQ",18,81,4.5,5,19,3.8,23,4.34782608695652
"eq6lQI039SBLC6sHm3idGA","rBPQuQgTcMtUq5-RYhY2uQ",18,81,4.5,8,15,1.875,26,3.69230769230769
"eq6lQI039SBLC6sHm3idGA","SLyacGZuMUKqrQJEooSkjw",18,81,4.5,7,22,3.14285714285714,25,4.12
"eq6lQI039SBLC6sHm3idGA","mU57qypB4nLScxgowHNEUA",18,81,4.5,3,6,2,21,4.14285714285714
"eq6lQI039SBLC6sHm3idGA","DO3Gk17RyJVW7zYMCtYPnw",18,81,4.5,10,37,3.7,28,4.21428571428571
"_6gbnNRPIc-iM_0cBLPX1A","BqrTtox0JbG-P_DKBB5bBw",3,10,3.33333333333333,18,69,3.83333333333333,21,3.76190476190476
"uYKwS-biARKgBkk5rY_PaQ","xhh72bIFefOaAxsj4vJJaA",5,24,4.8,1,4,4,6,4.66666666666667
"cMvN1j-LK64zqmT4vnl8NA","cN6qpVw6RaSrSI-JGGF4Tw",7,17,2.42857142857143,3,11,3.66666666666667,10,2.8
"cMvN1j-LK64zqmT4vnl8NA","zt1TpTuJ6y9n551sw9TaEg",7,17,2.42857142857143,22,67,3.04545454545455,29,2.89655172413793
"cMvN1j-LK64zqmT4vnl8NA","BqrTtox0JbG-P_DKBB5bBw",7,17,2.42857142857143,18,69,3.83333333333333,25,3.44
"cMvN1j-LK64zqmT4vnl8NA","zTCCbg7mGslxACL5KlAPIQ",7,17,2.42857142857143,6,14,2.33333333333333,13,2.38461538461538
"cMvN1j-LK64zqmT4vnl8NA","vKSRdX3g9kw3Xakw9FsyMQ",7,17,2.42857142857143,1,2,2,8,2.375
"cMvN1j-LK64zqmT4vnl8NA","_45p8kOA__aNycVVe-n-KA",7,17,2.42857142857143,1,4,4,8,2.625
"cMvN1j-LK64zqmT4vnl8NA","NxsCqQCpofRx08m535JYIA",7,17,2.42857142857143,1,4,4,8,2.625
"cMvN1j-LK64zqmT4vnl8NA","4EhFsjWBSaSp_5TkkLp7LA",7,17,2.42857142857143,3,8,2.66666666666667,10,2.5
"cMvN1j-LK64zqmT4vnl8NA","ASOiJ8MmbBTgK2D1_MQrqg",7,17,2.42857142857143,5,13,2.6,12,2.5
"cN6qpVw6RaSrSI-JGGF4Tw","BqrTtox0JbG-P_DKBB5bBw",3,11,3.66666666666667,18,69,3.83333333333333,21,3.80952380952381
"cN6qpVw6RaSrSI-JGGF4Tw","_45p8kOA__aNycVVe-n-KA",3,11,3.66666666666667,1,4,4,4,3.75
"cN6qpVw6RaSrSI-JGGF4Tw","NxsCqQCpofRx08m535JYIA",3,11,3.66666666666667,1,4,4,4,3.75
"zt1TpTuJ6y9n551sw9TaEg","bRYNYkMSghVlszXcOtA2XA",22,67,3.04545454545455,1,2,2,23,3
"zt1TpTuJ6y9n551sw9TaEg","QbmcCE_cLq4WO8ZMKImaLw",22,67,3.04545454545455,22,87,3.95454545454545,44,3.5
"zt1TpTuJ6y9n551sw9TaEg","BqD7X5CHXnJ14YbBBlLx1w",22,67,3.04545454545455,7,32,4.57142857142857,29,3.41379310344828
"zt1TpTuJ6y9n551sw9TaEg","zTCCbg7mGslxACL5KlAPIQ",22,67,3.04545454545455,6,14,2.33333333333333,28,2.89285714285714
"zt1TpTuJ6y9n551sw9TaEg","5rDosv0aIBhLg81IMSnlyg",22,67,3.04545454545455,2,9,4.5,24,3.16666666666667
"zt1TpTuJ6y9n551sw9TaEg","4EhFsjWBSaSp_5TkkLp7LA",22,67,3.04545454545455,3,8,2.66666666666667,25,3
"zt1TpTuJ6y9n551sw9TaEg","ASOiJ8MmbBTgK2D1_MQrqg",22,67,3.04545454545455,5,13,2.6,27,2.96296296296296
"BqrTtox0JbG-P_DKBB5bBw","Xhg93cMdemu5pAMkDoEdtQ",18,69,3.83333333333333,16,54,3.375,34,3.61764705882353
"BqrTtox0JbG-P_DKBB5bBw","2e2e7WgqU1BnpxmQL5jbfw",18,69,3.83333333333333,21,83,3.95238095238095,39,3.8974358974359
"BqrTtox0JbG-P_DKBB5bBw","_45p8kOA__aNycVVe-n-KA",18,69,3.83333333333333,1,4,4,19,3.84210526315789
"BqrTtox0JbG-P_DKBB5bBw","NxsCqQCpofRx08m535JYIA",18,69,3.83333333333333,1,4,4,19,3.84210526315789
"BqrTtox0JbG-P_DKBB5bBw","9CLZ-Uwv3nmOlbbGCIhvrQ",18,69,3.83333333333333,3,9,3,21,3.71428571428571
"BqrTtox0JbG-P_DKBB5bBw","4bEjOyTaDG24SY5TxsaUNQ",18,69,3.83333333333333,27,113,4.18518518518519,45,4.04444444444444
"BqrTtox0JbG-P_DKBB5bBw","DO3Gk17RyJVW7zYMCtYPnw",18,69,3.83333333333333,10,37,3.7,28,3.78571428571429
"dxY1gl4cO4-rEFATCkFUIw","QcTj9AgGJA0ifMHCCPNblg",8,25,3.125,1,2,2,9,3
"dxY1gl4cO4-rEFATCkFUIw","05tazaFQt1EnQ_Gk_1AFyg",8,25,3.125,5,22,4.4,13,3.61538461538462
"dxY1gl4cO4-rEFATCkFUIw","iXA8Y2bzvZo8MjALfZxrIg",8,25,3.125,3,13,4.33333333333333,11,3.45454545454545
"QRXv7Jvq_SuiiT_SKvbdig","SsTxjxo8qvqBMvan1rzNzg",5,21,4.2,10,38,3.8,15,3.93333333333333
"SwmStS3zjj94aV8M7kYqLg","zTCCbg7mGslxACL5KlAPIQ",7,30,4.28571428571429,6,14,2.33333333333333,13,3.38461538461538
"SwmStS3zjj94aV8M7kYqLg","mVJIPDv-qfYlatHYeP_saQ",7,30,4.28571428571429,2,9,4.5,9,4.33333333333333
"SwmStS3zjj94aV8M7kYqLg","rBPQuQgTcMtUq5-RYhY2uQ",7,30,4.28571428571429,8,15,1.875,15,3
"SwmStS3zjj94aV8M7kYqLg","6qXQQOWdUZiJmWVqkWB-3w",7,30,4.28571428571429,5,14,2.8,12,3.66666666666667
"SwmStS3zjj94aV8M7kYqLg","QJlab4DqvBRJPUfg7Vn5ZQ",7,30,4.28571428571429,4,18,4.5,11,4.36363636363636
"1U1GRksKXF7q8FKcW0e5VQ","uqisw8IXD5ZutU4MT2MQVw",2,10,5,7,22,3.14285714285714,9,3.55555555555556
"QbmcCE_cLq4WO8ZMKImaLw","BqD7X5CHXnJ14YbBBlLx1w",22,87,3.95454545454545,7,32,4.57142857142857,29,4.10344827586207
"QbmcCE_cLq4WO8ZMKImaLw","3fV9sL5LklD9ZSeONKmjkw",22,87,3.95454545454545,8,21,2.625,30,3.6
"QbmcCE_cLq4WO8ZMKImaLw","2e2e7WgqU1BnpxmQL5jbfw",22,87,3.95454545454545,21,83,3.95238095238095,43,3.95348837209302
"QbmcCE_cLq4WO8ZMKImaLw","WqdCrAhYSewDAom1qY-t_g",22,87,3.95454545454545,3,8,2.66666666666667,25,3.8
"QbmcCE_cLq4WO8ZMKImaLw","NK-8zniVfA21IQoQCynrDg",22,87,3.95454545454545,3,6,2,25,3.72
"QbmcCE_cLq4WO8ZMKImaLw","YNQgak-ZLtYJQxlDwN-qIg",22,87,3.95454545454545,8,21,2.625,30,3.6
"QbmcCE_cLq4WO8ZMKImaLw","aSZzH68--YxNQYAO5nKBkA",22,87,3.95454545454545,4,16,4,26,3.96153846153846
"QbmcCE_cLq4WO8ZMKImaLw","2a4OsAIvlWifELjogNPT1Q",22,87,3.95454545454545,1,3,3,23,3.91304347826087
"QbmcCE_cLq4WO8ZMKImaLw","R4_DQvJzYmWfFn1l-JPZMg",22,87,3.95454545454545,1,3,3,23,3.91304347826087
"QbmcCE_cLq4WO8ZMKImaLw","voPFKvVFm7b01xUyJixFYA",22,87,3.95454545454545,2,10,5,24,4.04166666666667
"QbmcCE_cLq4WO8ZMKImaLw","QJlab4DqvBRJPUfg7Vn5ZQ",22,87,3.95454545454545,4,18,4.5,26,4.03846153846154
"BqD7X5CHXnJ14YbBBlLx1w","bGj9djLAHjNR55OXsIDrAg",7,32,4.57142857142857,3,7,2.33333333333333,10,3.9
"BqD7X5CHXnJ14YbBBlLx1w","H52LFxw13LBS6_ewxCwlfg",7,32,4.57142857142857,4,7,1.75,11,3.54545454545455
"BqD7X5CHXnJ14YbBBlLx1w","uCoNIQty4nPrhn_WHo110A",7,32,4.57142857142857,5,21,4.2,12,4.41666666666667
"BqD7X5CHXnJ14YbBBlLx1w","vaq5SJubaZjIoGhgkwxxUA",7,32,4.57142857142857,1,5,5,8,4.625
"BqD7X5CHXnJ14YbBBlLx1w","rP76z9iDOFczywAiee-l7A",7,32,4.57142857142857,1,4,4,8,4.5
"BqD7X5CHXnJ14YbBBlLx1w","t65wgP7lQrCqxjBpMwOdbw",7,32,4.57142857142857,1,3,3,8,4.375
"Ieuv-XET6SR_qIscZzgD-A","2e2e7WgqU1BnpxmQL5jbfw",3,13,4.33333333333333,21,83,3.95238095238095,24,4
"Ieuv-XET6SR_qIscZzgD-A","aYEs_eXqnV8Ifj3Bp0bHwQ",3,13,4.33333333333333,3,12,4,6,4.16666666666667
"Ieuv-XET6SR_qIscZzgD-A","DO3Gk17RyJVW7zYMCtYPnw",3,13,4.33333333333333,10,37,3.7,13,3.84615384615385
"Ieuv-XET6SR_qIscZzgD-A","xyTJYlbE_MLouK6rCou6zg",3,13,4.33333333333333,6,20,3.33333333333333,9,3.66666666666667
"8Pzdk19tA2bKlKDSgwWqoQ","d38y2fkW1542SaoSTvE1og",6,21,3.5,1,4,4,7,3.57142857142857
"8Pzdk19tA2bKlKDSgwWqoQ","QJlab4DqvBRJPUfg7Vn5ZQ",6,21,3.5,4,18,4.5,10,3.9
"8Pzdk19tA2bKlKDSgwWqoQ","q4khSPgiGK9MoTu2NC2yTA",6,21,3.5,1,4,4,7,3.57142857142857
"zTCCbg7mGslxACL5KlAPIQ","bGj9djLAHjNR55OXsIDrAg",6,14,2.33333333333333,3,7,2.33333333333333,9,2.33333333333333
"zTCCbg7mGslxACL5KlAPIQ","vSf0pqvaLp5sVSjJPeOqqQ",6,14,2.33333333333333,3,14,4.66666666666667,9,3.11111111111111
"zTCCbg7mGslxACL5KlAPIQ","kwEQ3uY9Jwmknb5kNg3UlA",6,14,2.33333333333333,4,18,4.5,10,3.2
"zTCCbg7mGslxACL5KlAPIQ","4EhFsjWBSaSp_5TkkLp7LA",6,14,2.33333333333333,3,8,2.66666666666667,9,2.44444444444444
"zTCCbg7mGslxACL5KlAPIQ","ASOiJ8MmbBTgK2D1_MQrqg",6,14,2.33333333333333,5,13,2.6,11,2.45454545454545
"bGj9djLAHjNR55OXsIDrAg","vSf0pqvaLp5sVSjJPeOqqQ",3,7,2.33333333333333,3,14,4.66666666666667,6,3.5
"bGj9djLAHjNR55OXsIDrAg","H52LFxw13LBS6_ewxCwlfg",3,7,2.33333333333333,4,7,1.75,7,2
"bGj9djLAHjNR55OXsIDrAg","uCoNIQty4nPrhn_WHo110A",3,7,2.33333333333333,5,21,4.2,8,3.5
"vSf0pqvaLp5sVSjJPeOqqQ","2e2e7WgqU1BnpxmQL5jbfw",3,14,4.66666666666667,21,83,3.95238095238095,24,4.04166666666667
"vSf0pqvaLp5sVSjJPeOqqQ","szw8OGJlsqaA3i2oe7dn9A",3,14,4.66666666666667,5,16,3.2,8,3.75
"Xhg93cMdemu5pAMkDoEdtQ","naLrErBuJr9IWd6_rv6-XQ",16,54,3.375,6,28,4.66666666666667,22,3.72727272727273
"n8aEflHJYlK_c7yy8xkwpQ","05tazaFQt1EnQ_Gk_1AFyg",3,13,4.33333333333333,5,22,4.4,8,4.375
"fwcoLKfZYMH6nZbAaeD6sw","rYXu8NasDNnLZrmHymaQWg",1,4,4,1,5,5,2,4.5
"kwEQ3uY9Jwmknb5kNg3UlA","LLDGTT7FExklkQvHebEjRg",4,18,4.5,10,42,4.2,14,4.28571428571429
"js12Ev8XKlh36gZeGHzQnA","tFU2Js_nbIZOrnKfYJYBBg",2,5,2.5,8,34,4.25,10,3.9
"3fV9sL5LklD9ZSeONKmjkw","UpMR63WZgIn8VDKnYpDwXA",8,21,2.625,5,11,2.2,13,2.46153846153846
"3fV9sL5LklD9ZSeONKmjkw","J4qLz0nGzCTMf6-kf_SiQg",8,21,2.625,4,10,2.5,12,2.58333333333333
"3fV9sL5LklD9ZSeONKmjkw","vW4G1hwiW6LkuhAfbeRfqg",8,21,2.625,4,13,3.25,12,2.83333333333333
"3fV9sL5LklD9ZSeONKmjkw","tcphcsPONrP82kUyvcELoA",8,21,2.625,6,21,3.5,14,3
"naLrErBuJr9IWd6_rv6-XQ","O-_kxBV_IYdKlG98iqjQjw",6,28,4.66666666666667,1,4,4,7,4.57142857142857
"naLrErBuJr9IWd6_rv6-XQ","jOuERtVf7QePnK9ZcdH5XA",6,28,4.66666666666667,10,35,3.5,16,3.9375
"mANSEm_FbXK6qtB7n6nWgg","0InQd9vuhRc98OksC3Ks8Q",5,11,2.2,2,5,2.5,7,2.28571428571429
"mANSEm_FbXK6qtB7n6nWgg","rBPQuQgTcMtUq5-RYhY2uQ",5,11,2.2,8,15,1.875,13,2
"mANSEm_FbXK6qtB7n6nWgg","SLyacGZuMUKqrQJEooSkjw",5,11,2.2,7,22,3.14285714285714,12,2.75
"alWTl5MRC4VE2t9W1mNSIQ","jOuERtVf7QePnK9ZcdH5XA",5,17,3.4,10,35,3.5,15,3.46666666666667
"alWTl5MRC4VE2t9W1mNSIQ","YacTpiq0ZptFcXD7I-kdGA",5,17,3.4,4,19,4.75,9,4
"_xmJB767rROtAy6XepMlkQ","Shy4HqmyEewCLvq7Ub3Whg",4,11,2.75,2,8,4,6,3.16666666666667
"_tS0YfyPDxOXxrN4Kl2_HQ","6qXQQOWdUZiJmWVqkWB-3w",2,9,4.5,5,14,2.8,7,3.28571428571429
"2e2e7WgqU1BnpxmQL5jbfw","TN49j3bUJr3fuKCJkCatSA",21,83,3.95238095238095,1,2,2,22,3.86363636363636
"2e2e7WgqU1BnpxmQL5jbfw","b25jGkZerj2M4WAy95n1Tg",21,83,3.95238095238095,5,11,2.2,26,3.61538461538462
"2e2e7WgqU1BnpxmQL5jbfw","ROlYDMi1U3LaHStmuELRxQ",21,83,3.95238095238095,1,3,3,22,3.90909090909091
"2e2e7WgqU1BnpxmQL5jbfw","tcphcsPONrP82kUyvcELoA",21,83,3.95238095238095,6,21,3.5,27,3.85185185185185
"2e2e7WgqU1BnpxmQL5jbfw","YNQgak-ZLtYJQxlDwN-qIg",21,83,3.95238095238095,8,21,2.625,29,3.58620689655172
"2e2e7WgqU1BnpxmQL5jbfw","DO3Gk17RyJVW7zYMCtYPnw",21,83,3.95238095238095,10,37,3.7,31,3.87096774193548
"2e2e7WgqU1BnpxmQL5jbfw","xyTJYlbE_MLouK6rCou6zg",21,83,3.95238095238095,6,20,3.33333333333333,27,3.81481481481481
"2e2e7WgqU1BnpxmQL5jbfw","Zf7fMSe7yuW727JyikdBsg",21,83,3.95238095238095,9,19,2.11111111111111,30,3.4
"2e2e7WgqU1BnpxmQL5jbfw","q35bospqfYhJfMsqE79NvA",21,83,3.95238095238095,2,3,1.5,23,3.73913043478261
"WqdCrAhYSewDAom1qY-t_g","aSZzH68--YxNQYAO5nKBkA",3,8,2.66666666666667,4,16,4,7,3.42857142857143
"WqdCrAhYSewDAom1qY-t_g","2a4OsAIvlWifELjogNPT1Q",3,8,2.66666666666667,1,3,3,4,2.75
"WqdCrAhYSewDAom1qY-t_g","R4_DQvJzYmWfFn1l-JPZMg",3,8,2.66666666666667,1,3,3,4,2.75
"WqdCrAhYSewDAom1qY-t_g","voPFKvVFm7b01xUyJixFYA",3,8,2.66666666666667,2,10,5,5,3.6
"WqdCrAhYSewDAom1qY-t_g","YZuHOgbKiP3dN4_ROOUyDQ",3,8,2.66666666666667,5,23,4.6,8,3.875
"_45p8kOA__aNycVVe-n-KA","NxsCqQCpofRx08m535JYIA",1,4,4,1,4,4,2,4
"ME8gcI4BXjmFq7zEMtk3ag","nrnnVdMNJHn8H1FtcKeybg",1,4,4,1,3,3,2,3.5
"ME8gcI4BXjmFq7zEMtk3ag","xnRljkaR6zaVTpLYolQteg",1,4,4,3,10,3.33333333333333,4,3.5
"nrnnVdMNJHn8H1FtcKeybg","xnRljkaR6zaVTpLYolQteg",1,3,3,3,10,3.33333333333333,4,3.25
"xnRljkaR6zaVTpLYolQteg","btp0v0Qk7CmOmuMdt3aqkQ",3,10,3.33333333333333,1,5,5,4,3.75
"LTMEAdWM4m5tIDCSrkALIg","x42C5j84k0Y4H20fcJwbRQ",2,10,5,1,5,5,3,5
"LTMEAdWM4m5tIDCSrkALIg","YNQgak-ZLtYJQxlDwN-qIg",2,10,5,8,21,2.625,10,3.1
"Pz7SWZQhxL6ZbhL9jE2NTA","LLDGTT7FExklkQvHebEjRg",2,7,3.5,10,42,4.2,12,4.08333333333333
"Pz7SWZQhxL6ZbhL9jE2NTA","uqisw8IXD5ZutU4MT2MQVw",2,7,3.5,7,22,3.14285714285714,9,3.22222222222222
"Pz7SWZQhxL6ZbhL9jE2NTA","-5RN56jH78MV2oquLV_G8g",2,7,3.5,4,18,4.5,6,4.16666666666667
"LLDGTT7FExklkQvHebEjRg","mgy5TlydcKT1bFclh1FoaA",10,42,4.2,1,4,4,11,4.18181818181818
"LLDGTT7FExklkQvHebEjRg","uqisw8IXD5ZutU4MT2MQVw",10,42,4.2,7,22,3.14285714285714,17,3.76470588235294
"LLDGTT7FExklkQvHebEjRg","-5RN56jH78MV2oquLV_G8g",10,42,4.2,4,18,4.5,14,4.28571428571429
"LLDGTT7FExklkQvHebEjRg","88CNSyeoKhGn1x0SHvz8Ig",10,42,4.2,2,7,3.5,12,4.08333333333333
"mVJIPDv-qfYlatHYeP_saQ","QJlab4DqvBRJPUfg7Vn5ZQ",2,9,4.5,4,18,4.5,6,4.5
"H52LFxw13LBS6_ewxCwlfg","uCoNIQty4nPrhn_WHo110A",4,7,1.75,5,21,4.2,9,3.11111111111111
"a1t31qMLd5fQocEjbSJ61A","szw8OGJlsqaA3i2oe7dn9A",2,3,1.5,5,16,3.2,7,2.71428571428571
"a1t31qMLd5fQocEjbSJ61A","-5RN56jH78MV2oquLV_G8g",2,3,1.5,4,18,4.5,6,3.5
"a1t31qMLd5fQocEjbSJ61A","CZjcFdvJhksq9dy58NVEzw",2,3,1.5,6,19,3.16666666666667,8,2.75
"vEeiIvhzz29rO-6EPFqkjQ","ZNdsRbGeOfrYYPRl6AziCQ",3,15,5,4,17,4.25,7,4.57142857142857
"XDYnLQC8ViZejuCDp4eCwg","5rDosv0aIBhLg81IMSnlyg",2,5,2.5,2,9,4.5,4,3.5
"XDYnLQC8ViZejuCDp4eCwg","RRtu1D6qpVcpiQnMM8EhIg",2,5,2.5,1,3,3,3,2.66666666666667
"Gn7bMxhZgY0bivsthvJWJQ","uxrMmKqGDbEvxERs26rF2w",6,19,3.16666666666667,1,4,4,7,3.28571428571429
"8zL3V6rmFKBess3bxPLAoQ","J4qLz0nGzCTMf6-kf_SiQg",4,13,3.25,4,10,2.5,8,2.875
"8zL3V6rmFKBess3bxPLAoQ","tFU2Js_nbIZOrnKfYJYBBg",4,13,3.25,8,34,4.25,12,3.91666666666667
"8zL3V6rmFKBess3bxPLAoQ","4bEjOyTaDG24SY5TxsaUNQ",4,13,3.25,27,113,4.18518518518519,31,4.06451612903226
"kAXwEMkpcKMObw45QJGqnw","0_LZEAYsexEZS-OFTjdjNQ",4,17,4.25,2,5,2.5,6,3.66666666666667
"gGeVLZ9j_wAYKbaqgnKSJA","-2n-OHbbwIv3SY8RP9bgTQ",7,17,2.42857142857143,6,25,4.16666666666667,13,3.23076923076923
"9Bnc9YP0n5cR57xkP6fQmQ","83C1eqPfmQHTy_8MC4Ug6w",5,19,3.8,1,3,3,6,3.66666666666667
"uCoNIQty4nPrhn_WHo110A","YNx5vtfjtwXZEk2kBQoA9A",5,21,4.2,1,4,4,6,4.16666666666667
"uCoNIQty4nPrhn_WHo110A","YNQgak-ZLtYJQxlDwN-qIg",5,21,4.2,8,21,2.625,13,3.23076923076923
"UpMR63WZgIn8VDKnYpDwXA","vW4G1hwiW6LkuhAfbeRfqg",5,11,2.2,4,13,3.25,9,2.66666666666667
"UpMR63WZgIn8VDKnYpDwXA","tcphcsPONrP82kUyvcELoA",5,11,2.2,6,21,3.5,11,2.90909090909091
"uqisw8IXD5ZutU4MT2MQVw","-5RN56jH78MV2oquLV_G8g",7,22,3.14285714285714,4,18,4.5,11,3.63636363636364
"uqisw8IXD5ZutU4MT2MQVw","KjymOs12Mpy0Kd54b7T9MA",7,22,3.14285714285714,6,25,4.16666666666667,13,3.61538461538462
"aYEs_eXqnV8Ifj3Bp0bHwQ","N50HceZf1595UtU867u4uQ",3,12,4,4,15,3.75,7,3.85714285714286
"aYEs_eXqnV8Ifj3Bp0bHwQ","M2SjLXsuAy5RNKwxaA5E1g",3,12,4,4,15,3.75,7,3.85714285714286
"aYEs_eXqnV8Ifj3Bp0bHwQ","9CLZ-Uwv3nmOlbbGCIhvrQ",3,12,4,3,9,3,6,3.5
"aYEs_eXqnV8Ifj3Bp0bHwQ","aSZzH68--YxNQYAO5nKBkA",3,12,4,4,16,4,7,4
"J4qLz0nGzCTMf6-kf_SiQg","tFU2Js_nbIZOrnKfYJYBBg",4,10,2.5,8,34,4.25,12,3.66666666666667
"J4qLz0nGzCTMf6-kf_SiQg","4bEjOyTaDG24SY5TxsaUNQ",4,10,2.5,27,113,4.18518518518519,31,3.96774193548387
"TzOTe6yecv99lZuKQ6fPfA","vW4G1hwiW6LkuhAfbeRfqg",2,5,2.5,4,13,3.25,6,3
"Me4q6iXSjJyFsfKx-l3kcw","HY86y34XyAyUJyUXk5E43A",3,10,3.33333333333333,1,4,4,4,3.5
"N50HceZf1595UtU867u4uQ","M2SjLXsuAy5RNKwxaA5E1g",4,15,3.75,4,15,3.75,8,3.75
"N50HceZf1595UtU867u4uQ","9CLZ-Uwv3nmOlbbGCIhvrQ",4,15,3.75,3,9,3,7,3.42857142857143
"N50HceZf1595UtU867u4uQ","aSZzH68--YxNQYAO5nKBkA",4,15,3.75,4,16,4,8,3.875
"N50HceZf1595UtU867u4uQ","ecpYgTTQuXzmYNGxGTvbhw",4,15,3.75,2,10,5,6,4.16666666666667
"N50HceZf1595UtU867u4uQ","Q_Rwcv9APBLggk2KAsBEvg",4,15,3.75,5,17,3.4,9,3.55555555555556
"vW4G1hwiW6LkuhAfbeRfqg","tcphcsPONrP82kUyvcELoA",4,13,3.25,6,21,3.5,10,3.4
"rBPQuQgTcMtUq5-RYhY2uQ","SLyacGZuMUKqrQJEooSkjw",8,15,1.875,7,22,3.14285714285714,15,2.46666666666667
"a9fNfb-CIF4MnDnvX5tkOw","IaUXrUfy2iYrR6dHgvTpUg",1,4,4,1,3,3,2,3.5
"ZNdsRbGeOfrYYPRl6AziCQ","Q_Rwcv9APBLggk2KAsBEvg",4,17,4.25,5,17,3.4,9,3.77777777777778
"YNQgak-ZLtYJQxlDwN-qIg","4bEjOyTaDG24SY5TxsaUNQ",8,21,2.625,27,113,4.18518518518519,35,3.82857142857143
"YNQgak-ZLtYJQxlDwN-qIg","lvLPDHtI4eYrz5kz1_ATAw",8,21,2.625,1,1,1,9,2.44444444444444
"szw8OGJlsqaA3i2oe7dn9A","-5RN56jH78MV2oquLV_G8g",5,16,3.2,4,18,4.5,9,3.77777777777778
"szw8OGJlsqaA3i2oe7dn9A","CZjcFdvJhksq9dy58NVEzw",5,16,3.2,6,19,3.16666666666667,11,3.18181818181818
"szw8OGJlsqaA3i2oe7dn9A","4bEjOyTaDG24SY5TxsaUNQ",5,16,3.2,27,113,4.18518518518519,32,4.03125
"szw8OGJlsqaA3i2oe7dn9A","Ensu96ecI0OReupNS2x7ig",5,16,3.2,3,9,3,8,3.125
"M2SjLXsuAy5RNKwxaA5E1g","9CLZ-Uwv3nmOlbbGCIhvrQ",4,15,3.75,3,9,3,7,3.42857142857143
"M2SjLXsuAy5RNKwxaA5E1g","aSZzH68--YxNQYAO5nKBkA",4,15,3.75,4,16,4,8,3.875
"M2SjLXsuAy5RNKwxaA5E1g","Q_Rwcv9APBLggk2KAsBEvg",4,15,3.75,5,17,3.4,9,3.55555555555556
"jOuERtVf7QePnK9ZcdH5XA","YacTpiq0ZptFcXD7I-kdGA",10,35,3.5,4,19,4.75,14,3.85714285714286
"9CLZ-Uwv3nmOlbbGCIhvrQ","aSZzH68--YxNQYAO5nKBkA",3,9,3,4,16,4,7,3.57142857142857
"9CLZ-Uwv3nmOlbbGCIhvrQ","4bEjOyTaDG24SY5TxsaUNQ",3,9,3,27,113,4.18518518518519,30,4.06666666666667
"aSZzH68--YxNQYAO5nKBkA","2a4OsAIvlWifELjogNPT1Q",4,16,4,1,3,3,5,3.8
"aSZzH68--YxNQYAO5nKBkA","R4_DQvJzYmWfFn1l-JPZMg",4,16,4,1,3,3,5,3.8
"aSZzH68--YxNQYAO5nKBkA","voPFKvVFm7b01xUyJixFYA",4,16,4,2,10,5,6,4.33333333333333
"-5RN56jH78MV2oquLV_G8g","CZjcFdvJhksq9dy58NVEzw",4,18,4.5,6,19,3.16666666666667,10,3.7
"5rDosv0aIBhLg81IMSnlyg","RRtu1D6qpVcpiQnMM8EhIg",2,9,4.5,1,3,3,3,4
"2a4OsAIvlWifELjogNPT1Q","R4_DQvJzYmWfFn1l-JPZMg",1,3,3,1,3,3,2,3
"2a4OsAIvlWifELjogNPT1Q","voPFKvVFm7b01xUyJixFYA",1,3,3,2,10,5,3,4.33333333333333
"R4_DQvJzYmWfFn1l-JPZMg","voPFKvVFm7b01xUyJixFYA",1,3,3,2,10,5,3,4.33333333333333
"SLyacGZuMUKqrQJEooSkjw","ASOiJ8MmbBTgK2D1_MQrqg",7,22,3.14285714285714,5,13,2.6,12,2.91666666666667
"mU57qypB4nLScxgowHNEUA","TSSNmAcPraYae5yprqaEnQ",3,6,2,1,4,4,4,2.5
"bmNPNlCLDplWB55ic3Bixg","VnTREYYq-cquQ3f2re8iBg",6,24,4,1,2,2,7,3.71428571428571
"4EhFsjWBSaSp_5TkkLp7LA","ASOiJ8MmbBTgK2D1_MQrqg",3,8,2.66666666666667,5,13,2.6,8,2.625
"tFU2Js_nbIZOrnKfYJYBBg","4bEjOyTaDG24SY5TxsaUNQ",8,34,4.25,27,113,4.18518518518519,35,4.2
"SsTxjxo8qvqBMvan1rzNzg","Zf7fMSe7yuW727JyikdBsg",10,38,3.8,9,19,2.11111111111111,19,3
"4bEjOyTaDG24SY5TxsaUNQ","xyTJYlbE_MLouK6rCou6zg",27,113,4.18518518518519,6,20,3.33333333333333,33,4.03030303030303
"4bEjOyTaDG24SY5TxsaUNQ","Ensu96ecI0OReupNS2x7ig",27,113,4.18518518518519,3,9,3,30,4.06666666666667
"5IWu0xhlZEopvIz3w7o_3w","uCZe5GLqTeadjTLlvWNF4w",2,9,4.5,1,4,4,3,4.33333333333333
"DO3Gk17RyJVW7zYMCtYPnw","xyTJYlbE_MLouK6rCou6zg",10,37,3.7,6,20,3.33333333333333,16,3.5625
"rP76z9iDOFczywAiee-l7A","t65wgP7lQrCqxjBpMwOdbw",1,4,4,1,3,3,2,3.5
"ecpYgTTQuXzmYNGxGTvbhw","Q_Rwcv9APBLggk2KAsBEvg",2,10,5,5,17,3.4,7,3.85714285714286
"MWkIQNT5ewKwMfKbixgb6Q","JtvwIwSl6rXVKacqP8avyw",3,11,3.66666666666667,1,1,1,4,3
"HT-3izSFU8ZMazvSqrADyw","sxRI0je6hAR-MeBDxdyhug",2,4,2,1,3,3,3,2.33333333333333
"QJlab4DqvBRJPUfg7Vn5ZQ","q4khSPgiGK9MoTu2NC2yTA",4,18,4.5,1,4,4,5,4.4
